8
4
2 1
42 51
x x x 0 0 0 0 0 0 0 0 0 0 0 0 0 0 0 0 0 0 0 0 0 0 0 0 0 0 0 0 0 0 0 0 0 0 0 0 0 0 0 0 0 0 0 0 0 x x x 
x x 0 0 0 0 0 0 0 0 0 0 0 0 0 0 0 0 0 0 0 0 0 0 0 0 0 0 0 0 0 0 0 0 0 0 0 0 0 0 0 0 0 0 0 0 0 0 0 x x 
x 0 0 0 0 0 0 0 0 0 0 0 0 0 0 0 0 0 0 0 0 0 0 0 0 0 0 0 0 0 0 0 0 0 0 0 0 0 0 0 0 0 0 0 0 0 0 0 0 0 x 
0 0 0 0 0 0 0 0 0 0 0 0 0 - - - - - - - - - - - - - - - - - - - - - - - - - 0 0 0 0 0 0 0 0 0 0 0 0 0 
0 0 0 0 7 8 0 0 0 0 0 0 - - - - - - - - - - - - - - - - - - - - - - - - - - - 0 0 0 0 0 0 6 5 0 0 0 0 
0 0 0 0 8 7 0 0 0 0 0 - - - - - - - - - - - - - - - - - - - - - - - - - - - - - 0 0 0 0 0 5 6 0 0 0 0 
0 0 0 0 0 0 0 0 0 0 - - - 0 0 0 0 - - - - - - - - - - - - - - - 0 0 0 0 - - - - - 0 0 0 0 0 0 0 0 0 0 
0 0 0 0 0 0 0 0 0 - - - 0 0 0 0 - - - - - - - - - - - - - - - - - x x x - - - - - - 0 0 0 0 0 0 0 0 0 
0 0 0 0 0 0 0 0 - - - 0 0 0 0 - - - - - 0 0 0 0 0 0 0 0 0 0 0 - - - x - - - - 0 - - - 0 0 0 0 0 0 0 0 
0 0 0 0 0 0 0 - - - 0 0 0 - - - - - 0 0 0 0 0 0 0 0 0 0 0 0 0 0 - - - - - - - 0 0 - - - 0 0 0 0 0 0 0 
0 0 0 0 0 0 - - - 0 0 0 0 - - - - 0 0 0 0 0 0 0 0 0 0 0 0 0 0 0 0 - - - - - 0 0 0 0 - - - 0 0 0 0 0 0 
0 0 0 0 0 - - - 0 0 0 - - - - - 0 0 0 0 0 0 0 0 0 c 0 0 0 0 0 0 0 0 - - - - 0 0 0 0 0 - - - 0 0 0 0 0 
0 0 0 0 - - - 0 0 0 0 - - - - x 0 0 0 0 0 0 0 0 0 0 0 0 0 0 0 0 0 0 0 0 0 0 0 0 0 0 0 0 - - - 0 0 0 0 
0 0 0 - - - 0 0 0 - - - - - - x x 0 0 0 0 0 0 0 0 0 0 0 0 0 0 0 0 0 0 0 0 0 0 0 0 0 0 0 0 - - - 0 0 0 
0 0 - - - x 0 0 0 - - - - - - x 0 0 0 0 0 0 0 0 0 0 0 0 0 0 0 0 0 0 0 0 0 0 0 0 0 0 0 0 0 x - - - 0 0 
0 0 - - x x 0 0 - - - - - - - - 0 0 0 0 0 0 0 0 0 0 0 0 0 0 0 0 0 0 0 0 0 0 0 0 0 0 0 0 0 x x - - 0 0 
0 0 - - - x 0 0 - - - - - - - - - 0 0 0 0 0 0 0 0 0 0 0 0 0 0 0 0 0 0 0 0 0 0 0 0 0 0 0 0 x - - - 0 0 
0 0 0 - - x 0 0 - - - - - - - - - - - - - - - - - - - - - - - - 0 0 0 0 0 0 0 0 0 0 0 0 0 - - - 0 0 0 
0 0 0 0 - - - 0 0 - - - - - - - - - - - - - - - - - - - - - - - - - 0 0 0 0 0 0 0 0 0 0 - - - 0 0 0 0 
0 0 0 0 0 - - - 0 - - - - - - - - - - - - - - - - - - - - - - - - - - - - 0 0 0 0 0 0 - - - 0 0 0 0 0 
0 0 0 0 0 0 - - - 0 0 - - - - - - - - - - - - - - - - - - - - - - - - - - - 0 0 0 0 - - - 0 0 0 0 0 0 
0 0 0 0 0 0 0 - - - - 0 0 - - - - - - - - - - - - - - - - - - - - - - - - - - 0 0 - - - 0 0 0 0 0 0 0 
0 0 0 0 0 0 0 0 - - - 0 0 0 0 0 - - - - - - - - - - - - - - - - - - - - - - - 0 - - - 0 0 0 0 0 0 0 0 
0 0 0 0 0 0 0 0 0 - - - 0 0 0 0 0 0 0 0 0 0 0 0 0 0 0 0 0 0 - - - - - - - - - - - - 0 0 0 0 0 0 0 0 0 
0 0 0 0 0 0 0 0 0 0 - - - 0 0 0 0 0 0 0 0 0 0 0 0 0 0 0 0 0 0 0 x x - - - - - - - 0 0 0 0 0 0 0 0 0 0 
0 0 0 0 0 0 0 0 0 0 0 - - - 0 0 0 - - - - 0 0 0 0 c 0 0 0 0 0 0 x x - - - - - - 0 0 0 0 0 0 0 0 0 0 0 
0 0 0 0 0 0 0 0 0 0 0 0 - - - 0 - - - - - 0 0 0 0 0 0 0 0 0 0 0 x - - - - - - 0 0 0 0 0 0 0 0 0 0 0 0 
0 0 0 0 0 0 0 0 0 0 0 0 0 - - - - - - - - - - 0 0 0 0 0 0 0 0 - - - - - - - 0 0 0 0 0 0 0 0 0 0 0 0 0 
0 0 0 0 0 0 0 0 0 0 0 0 0 0 - - - - - - - - - - 0 0 0 0 - - - - - - - - - 0 0 0 0 0 0 0 0 0 0 0 0 0 0 
0 0 0 0 0 0 0 0 0 0 0 0 0 0 0 - - - - - - - - - - - - - - - - - - - - - 0 0 0 0 0 0 0 0 0 0 0 0 0 0 0 
0 0 0 0 0 0 0 0 0 0 0 0 0 0 0 0 - - - x - - - - - - - - - - - x - - - 0 0 0 0 0 0 0 0 0 0 0 0 0 0 0 0 
0 0 0 0 0 0 0 0 0 0 0 0 0 0 0 0 0 - - - 0 0 0 - - - - - 0 0 0 - - - 0 0 0 0 0 0 0 0 0 0 0 0 0 0 0 0 0 
0 0 0 0 0 0 0 0 0 0 0 0 0 0 0 0 0 0 - - - 0 0 0 0 0 0 0 0 0 - - - 0 0 0 0 0 0 0 0 0 0 0 0 0 0 0 0 0 0 
0 0 0 0 0 0 0 0 0 0 0 0 0 0 0 0 0 0 0 - - - 0 0 0 0 0 0 0 - - - 0 0 0 0 0 0 0 0 0 0 0 0 0 0 0 0 0 0 0 
0 0 0 0 0 0 0 0 0 0 0 0 0 0 0 0 0 0 0 0 - - - 0 0 0 0 0 - - - 0 0 0 0 0 0 0 0 0 0 0 0 0 0 0 0 0 0 0 0 
0 0 0 0 0 2 1 0 0 0 0 0 0 0 0 0 0 0 0 0 0 - - - x x x - - - 0 0 0 0 0 0 0 0 0 0 0 0 0 0 3 4 0 0 0 0 0 
0 0 0 0 0 1 2 0 0 0 0 0 0 0 0 0 0 0 0 0 0 0 - - - x - - - 0 0 0 0 0 0 0 0 0 0 0 0 0 0 0 4 3 0 0 0 0 0 
0 0 0 0 0 0 0 0 0 0 0 0 0 0 0 0 0 0 0 0 0 0 0 - - - - - 0 0 0 0 0 0 0 0 0 0 0 0 0 0 0 0 0 0 0 0 0 0 0 
0 0 0 0 0 0 0 0 0 0 0 0 0 0 0 0 0 0 0 0 0 0 0 0 - - - 0 0 0 0 0 0 0 0 0 0 0 0 0 0 0 0 0 0 0 0 0 0 0 0 
x 0 0 0 0 0 0 0 0 0 0 0 0 0 0 0 0 0 0 0 0 0 0 0 0 - 0 0 0 0 0 0 0 0 0 0 0 0 0 0 0 0 0 0 0 0 0 0 0 0 x 
x x 0 0 0 0 0 0 0 0 0 0 0 0 0 0 0 0 0 0 0 0 0 0 0 0 0 0 0 0 0 0 0 0 0 0 0 0 0 0 0 0 0 0 0 0 0 0 0 x x 
x x x 0 0 0 0 0 0 0 0 0 0 0 0 0 0 0 0 0 0 0 0 0 0 0 0 0 0 0 0 0 0 0 0 0 0 0 0 0 0 0 0 0 0 0 0 0 x x x 
46 15 2 <-> 15 13 6
34 8 4 <-> 4 15 6
25 40 0 <-> 25 36 4
15 22 0 <-> 33 24 2
49 15 6 <-> 1 15 2
7 7 3 <-> 37 28 7
43 7 5 <-> 13 28 1
13 6 0 <-> 39 22 4
39 8 0 <-> 15 26 4
