3
1
1 1
31 31
b 0 0 0 0 0 0 0 0 0 0 0 0 0 0 0 0 0 0 0 0 0 0 0 0 0 0 0 0 0 b 
0 0 0 0 0 0 0 0 0 0 0 0 0 0 0 0 0 0 0 0 0 0 0 0 0 0 0 0 0 0 0 
0 0 0 0 0 0 0 0 0 0 0 0 0 0 0 0 0 0 0 0 0 0 0 0 0 0 0 0 0 0 0 
0 0 0 - - - - - - - - - - - - - - - - - - - - - - - - - 0 0 0 
0 0 0 - c 0 0 0 0 0 0 0 0 0 0 0 0 0 0 0 0 0 0 0 0 0 i - 0 0 0 
0 0 0 - 0 0 0 0 0 0 0 0 0 0 0 0 0 0 0 0 0 0 0 0 0 0 0 - 0 0 0 
0 0 0 - 0 0 0 0 0 0 0 0 0 0 0 0 0 0 0 0 0 0 0 0 0 0 0 - 0 0 0 
0 0 0 - 0 0 0 - - - - - - - - - - - - - - - - - 0 0 0 - 0 0 0 
0 0 0 - 0 0 0 - i 0 0 0 0 0 0 0 0 0 0 0 0 0 c - 0 0 0 - 0 0 0 
0 0 0 - 0 0 0 - 0 0 0 0 0 0 0 0 0 0 0 0 0 0 0 - 0 0 0 - 0 0 0 
0 0 0 - 0 0 0 - 0 0 0 0 0 0 0 0 0 0 0 0 0 0 0 - 0 0 0 - 0 0 0 
0 0 0 - 0 0 0 - 0 0 0 - - - - - - - - - 0 0 0 - 0 0 0 - 0 0 0 
0 0 0 - 0 0 0 - 0 0 0 - 0 0 0 0 0 0 0 - 0 0 0 - 0 0 0 - 0 0 0 
0 0 0 - 0 0 0 - 0 0 0 - 0 0 0 0 0 0 0 - 0 0 0 - 0 0 0 - 0 0 0 
0 0 0 - 0 0 0 - 0 0 0 - 0 0 1 2 3 0 0 - 0 0 0 - 0 0 0 - 0 0 0 
0 0 0 - 0 0 0 - 0 0 0 - 0 0 3 1 2 0 0 - 0 0 0 - 0 0 0 - 0 0 0 
0 0 0 - 0 0 0 - 0 0 0 - 0 0 2 3 1 0 0 - 0 0 0 - 0 0 0 - 0 0 0 
0 0 0 - 0 0 0 - 0 0 0 - 0 0 0 0 0 0 0 - 0 0 0 - 0 0 0 - 0 0 0 
0 0 0 - 0 0 0 - 0 0 0 - 0 0 0 0 0 0 0 - 0 0 0 - 0 0 0 - 0 0 0 
0 0 0 - 0 0 0 - 0 0 0 - - - - - - - - - 0 0 0 - 0 0 0 - 0 0 0 
0 0 0 - 0 0 0 - 0 0 0 0 0 0 0 0 0 0 0 0 0 0 0 - 0 0 0 - 0 0 0 
0 0 0 - 0 0 0 - 0 0 0 0 0 0 0 0 0 0 0 0 0 0 0 - 0 0 0 - 0 0 0 
0 0 0 - 0 0 0 - c 0 0 0 0 0 0 0 0 0 0 0 0 0 i - 0 0 0 - 0 0 0 
0 0 0 - 0 0 0 - - - - - - - - - - - - - - - - - 0 0 0 - 0 0 0 
0 0 0 - 0 0 0 0 0 0 0 0 0 0 0 0 0 0 0 0 0 0 0 0 0 0 0 - 0 0 0 
0 0 0 - 0 0 0 0 0 0 0 0 0 0 0 0 0 0 0 0 0 0 0 0 0 0 0 - 0 0 0 
0 0 0 - i 0 0 0 0 0 0 0 0 0 0 0 0 0 0 0 0 0 0 0 0 0 c - 0 0 0 
0 0 0 - - - - - - - - - - - - - - - - - - - - - - - - - 0 0 0 
0 0 0 0 0 0 0 0 0 0 0 0 0 0 0 0 0 0 0 0 0 0 0 0 0 0 0 0 0 0 0 
0 0 0 0 0 0 0 0 0 0 0 0 0 0 0 0 0 0 0 0 0 0 0 0 0 0 0 0 0 0 0 
b 0 0 0 0 0 0 0 0 0 0 0 0 0 0 0 0 0 0 0 0 0 0 0 0 0 0 0 0 0 b 
10 6 4 <-> 15 18 4
28 8 6 <-> 12 15 6
15 12 0 <-> 2 22 2
6 10 2 <-> 22 28 0
20 6 4 <-> 2 8 2
8 2 4 <-> 28 22 6
22 2 4 <-> 6 20 2
18 15 2 <-> 8 28 0
24 10 6 <-> 24 20 6
21 24 0 <-> 21 22 4
9 22 4 <-> 9 24 0
8 21 6 <-> 6 21 2
6 9 2 <-> 8 9 6
9 6 4 <-> 9 8 0
21 6 4 <-> 21 8 0
24 9 6 <-> 22 9 2
22 21 2 <-> 24 21 6
