8
4
2 1
42 49
0 x 0 0 0 0 0 0 0 0 0 0 0 0 0 0 0 0 0 0 0 0 0 0 0 0 0 0 0 0 0 0 0 0 0 0 0 0 0 0 0 0 0 0 0 0 0 x 0 
x x 0 0 0 0 0 0 0 0 0 0 0 0 0 0 0 0 0 0 0 0 0 0 0 0 0 0 0 0 0 0 0 0 0 0 0 0 0 0 0 0 0 0 0 0 0 x x 
0 0 0 0 0 0 0 0 0 0 0 0 0 0 0 0 0 0 0 0 0 0 0 0 0 0 0 0 0 0 0 0 0 0 0 0 0 0 0 0 0 0 0 0 0 0 0 0 0 
0 0 0 0 0 0 0 0 0 0 0 0 - - - - - - - - - - - - - - - - - - - - - - - - - 0 0 0 0 0 0 0 0 0 0 0 0 
0 0 0 7 8 0 0 0 0 0 0 - - - - - - - - - - - - - - - - - - - - - - - - - - - 0 0 0 0 0 0 6 5 0 0 0 
0 0 0 8 7 0 0 0 0 0 - - - - - - - - - - - - - - - - - - - - - - - - - - - - - 0 0 0 0 0 5 6 0 0 0 
0 0 0 0 0 0 0 0 0 - - - 0 0 0 0 - - - - - - - - - - - - - - - 0 0 0 0 - - - - - 0 0 0 0 0 0 0 0 0 
0 0 0 0 0 0 0 0 - - - 0 0 0 0 - - - - - - - - - - - - - - - - - x x x - - - - - - 0 0 0 0 0 0 0 0 
0 0 0 0 0 0 0 - - - 0 0 0 0 - - - - - 0 0 0 0 0 0 0 0 0 0 0 - - - x - - - - 0 - - - 0 0 0 0 0 0 0 
0 0 0 0 0 0 - - - 0 0 0 - - - - - 0 0 0 0 0 0 0 0 0 0 0 0 0 0 - - - - - - - 0 0 - - - 0 0 0 0 0 0 
0 0 0 0 0 - - - 0 0 0 0 - - - - 0 0 0 0 0 0 0 0 0 0 0 0 0 0 0 0 - - - - - 0 0 0 0 - - - 0 0 0 0 0 
0 0 0 0 - - - 0 0 0 - - - - - 0 0 0 0 0 0 0 0 0 c 0 0 0 0 0 0 0 0 - - - - 0 0 0 0 0 - - - 0 0 0 0 
0 0 0 - - - 0 0 0 0 - - - - x 0 0 0 0 0 0 0 0 0 0 0 0 0 0 0 0 0 0 0 0 0 0 0 0 0 0 0 0 - - - 0 0 0 
0 0 - - - 0 0 0 - - - - - - x x 0 0 0 0 0 0 0 0 0 0 0 0 0 0 0 0 0 0 0 0 0 0 0 0 0 0 0 0 - - - 0 0 
0 - - - x 0 0 0 - - - - - - x 0 0 0 0 0 0 0 0 0 0 0 0 0 0 0 0 0 0 0 0 0 0 0 0 0 0 0 0 0 x - - - 0 
0 - - x x 0 0 - - - - - - - - 0 0 0 0 0 0 0 0 0 0 0 0 0 0 0 0 0 0 0 0 0 0 0 0 0 0 0 0 0 x x - - 0 
0 - - - x 0 0 - - - - - - - - - 0 0 0 0 0 0 0 0 0 0 0 0 0 0 0 0 0 0 0 0 0 0 0 0 0 0 0 0 x - - - 0 
0 0 - - x 0 0 - - - - - - - - - - - - - - - - - - - - - - - - 0 0 0 0 0 0 0 0 0 0 0 0 0 - - - 0 0 
0 0 0 - - - 0 0 - - - - - - - - - - - - - - - - - - - - - - - - - 0 0 0 0 0 0 0 0 0 0 - - - 0 0 0 
0 0 0 0 - - - 0 - - - - - - - - - - - - - - - - - - - - - - - - - - - - 0 0 0 0 0 0 - - - 0 0 0 0 
0 0 0 0 0 - - - 0 0 - - - - - - - - - - - - - - - - - - - - - - - - - - - 0 0 0 0 - - - 0 0 0 0 0 
0 0 0 0 0 0 - - - - 0 0 - - - - - - - - - - - - - - - - - - - - - - - - - - 0 0 - - - 0 0 0 0 0 0 
0 0 0 0 0 0 0 - - - 0 0 0 0 0 - - - - - - - - - - - - - - - - - - - - - - - 0 - - - 0 0 0 0 0 0 0 
0 0 0 0 0 0 0 0 - - - 0 0 0 0 0 0 0 0 0 0 0 0 0 0 0 0 0 0 - - - - - - - - - - - - 0 0 0 0 0 0 0 0 
0 0 0 0 0 0 0 0 0 - - - 0 0 0 0 0 0 0 0 0 0 0 0 0 0 0 0 0 0 0 x x - - - - - - - 0 0 0 0 0 0 0 0 0 
0 0 0 0 0 0 0 0 0 0 - - - 0 0 0 - - - - 0 0 0 0 c 0 0 0 0 0 0 x x - - - - - - 0 0 0 0 0 0 0 0 0 0 
0 0 0 0 0 0 0 0 0 0 0 - - - 0 - - - - - 0 0 0 0 0 0 0 0 0 0 0 x - - - - - - 0 0 0 0 0 0 0 0 0 0 0 
0 0 0 0 0 0 0 0 0 0 0 0 - - - - - - - - - - 0 0 0 0 0 0 0 0 - - - - - - - 0 0 0 0 0 0 0 0 0 0 0 0 
0 0 0 0 0 0 0 0 0 0 0 0 0 - - - - - - - - - - 0 0 0 0 - - - - - - - - - 0 0 0 0 0 0 0 0 0 0 0 0 0 
0 0 0 0 0 0 0 0 0 0 0 0 0 0 - - - - - - - - - - - - - - - - - - - - - 0 0 0 0 0 0 0 0 0 0 0 0 0 0 
0 0 0 0 0 0 0 0 0 0 0 0 0 0 0 - - - x - - - - - - - - - - - x - - - 0 0 0 0 0 0 0 0 0 0 0 0 0 0 0 
0 0 0 0 0 0 0 0 0 0 0 0 0 0 0 0 - - - 0 0 0 - - - - - 0 0 0 - - - 0 0 0 0 0 0 0 0 0 0 0 0 0 0 0 0 
0 0 0 0 0 0 0 0 0 0 0 0 0 0 0 0 0 - - - 0 0 0 0 0 0 0 0 0 - - - 0 0 0 0 0 0 0 0 0 0 0 0 0 0 0 0 0 
0 0 0 0 0 0 0 0 0 0 0 0 0 0 0 0 0 0 - - - 0 0 0 0 0 0 0 - - - 0 0 0 0 0 0 0 0 0 0 0 0 0 0 0 0 0 0 
0 0 0 0 0 0 0 0 0 0 0 0 0 0 0 0 0 0 0 - - - 0 0 0 0 0 - - - 0 0 0 0 0 0 0 0 0 0 0 0 0 0 0 0 0 0 0 
0 0 0 0 2 1 0 0 0 0 0 0 0 0 0 0 0 0 0 0 - - - x x x - - - 0 0 0 0 0 0 0 0 0 0 0 0 0 0 3 4 0 0 0 0 
0 0 0 0 1 2 0 0 0 0 0 0 0 0 0 0 0 0 0 0 0 - - - x - - - 0 0 0 0 0 0 0 0 0 0 0 0 0 0 0 4 3 0 0 0 0 
0 0 0 0 0 0 0 0 0 0 0 0 0 0 0 0 0 0 0 0 0 0 - - - - - 0 0 0 0 0 0 0 0 0 0 0 0 0 0 0 0 0 0 0 0 0 0 
0 0 0 0 0 0 0 0 0 0 0 0 0 0 0 0 0 0 0 0 0 0 0 - - - 0 0 0 0 0 0 0 0 0 0 0 0 0 0 0 0 0 0 0 0 0 0 0 
0 0 0 0 0 0 0 0 0 0 0 0 0 0 0 0 0 0 0 0 0 0 0 0 - 0 0 0 0 0 0 0 0 0 0 0 0 0 0 0 0 0 0 0 0 0 0 0 0 
x x 0 0 0 0 0 0 0 0 0 0 0 0 0 0 0 0 0 0 0 0 0 0 0 0 0 0 0 0 0 0 0 0 0 0 0 0 0 0 0 0 0 0 0 0 0 x x 
0 x 0 0 0 0 0 0 0 0 0 0 0 0 0 0 0 0 0 0 0 0 0 0 0 0 0 0 0 0 0 0 0 0 0 0 0 0 0 0 0 0 0 0 0 0 0 x 0 
45 15 2 <-> 14 13 6
33 8 4 <-> 3 15 6
24 40 0 <-> 24 36 4
14 22 0 <-> 32 24 2
48 15 6 <-> 0 15 2
6 7 3 <-> 36 28 7
42 7 5 <-> 12 28 1
12 6 0 <-> 38 22 4
38 8 0 <-> 14 26 4
24 2 4 <-> 24 8 0
23 2 4 <-> 23 23 0
24 41 4 <-> 24 28 4
25 2 4 <-> 25 23 0
44 21 7 <-> 41 18 3
35 30 7 <-> 29 26 3
