3
4
2 2
13 17
- - - - - - - - c - - - - - - - -
- - - - - - - 0 0 0 - - - - - - -
- - - - - - 0 0 0 0 0 - - - - - -
- - - - - 0 0 0 0 0 0 0 - - - - -
0 0 0 0 0 0 0 0 0 0 0 0 0 0 0 0 0
- 0 0 x x 0 0 2 1 3 0 0 x x 0 0 -
- - 0 0 x 0 0 3 2 1 0 0 x 0 0 - -
- - - 0 0 0 0 1 3 2 0 0 0 0 - - -
- - - - 0 0 0 0 0 0 0 0 0 - - - -
- - - 0 0 i 0 0 0 0 0 i 0 0 - - -
- - 0 0 0 0 0 0 - 0 0 0 0 0 0 - -
- 0 b 0 0 0 - - - - - 0 0 0 b 0 -
0 0 0 - - - - - - - - - - - 0 0 0
0 4 6 <-> 16 12 3
16 4 2 <-> 0 12 5