2
0
0 0
10 10
1 0 - - - - - - 0 2 
0 0 0 1 - 1 0 0 0 0 
- 0 0 0 0 0 0 0 0 - 
- 0 0 0 0 0 0 0 2 - 
- 2 0 0 0 0 0 0 - - 
- - 0 0 0 0 0 0 2 - 
- 2 0 0 0 0 0 0 0 - 
- 0 0 0 0 0 0 0 0 - 
0 0 0 0 1 - 1 0 0 0 
2 0 - - - - - - 0 1 
