2
8
4 3
20 20
- 0 0 0 0 0 0 0 0 0 0 0 0 0 0 0 0 0 x x
0 0 0 0 0 0 0 0 0 0 0 0 0 0 0 0 0 0 0 x
- 0 c 0 0 0 0 0 0 - - 0 0 0 0 0 i 0 0 0
- 0 0 0 0 0 0 0 - - - - 0 0 0 0 0 0 0 1
- 0 0 0 0 0 1 - - - - - - 0 0 0 1 2 0 0
0 0 0 0 0 0 - - - - - - - - 0 0 0 0 0 0
0 0 0 0 0 - - - - - - - - - - 0 0 0 0 0
0 0 0 0 - - - - - - - - - - - - 0 0 0 2
0 0 0 - - - - - 0 0 0 0 - - - - - 0 0 3
0 0 - - - - - - 0 1 2 0 - - - - - - 0 4
0 0 - - - - - - 0 2 1 0 - - - - - - 0 5
0 0 0 - - - - - 0 0 0 0 - - - - - 0 0 0
0 0 0 1 - - - - - - - - - - - - 0 0 0 0
0 0 0 0 0 - - - - - - - - - - 0 0 0 0 0
0 0 0 0 0 0 - - - - - - - - 0 0 0 0 0 0
0 0 0 0 0 0 0 - - - - - - 0 0 0 0 0 0 1
0 0 0 0 0 0 0 0 - - - - 0 0 0 0 0 0 0 0
0 0 i 0 0 0 0 0 0 - - 0 0 0 0 0 b 0 0 0
x 0 0 0 0 0 0 0 0 0 0 0 0 0 0 0 0 0 0 x
x x 0 0 0 0 0 0 0 0 0 0 0 0 0 0 0 0 x 1
8 8 7 <-> 19 0 1
9 8 0 <-> 19 15 2
10 8 0 <-> 0 4 6
11 8 1 <-> 0 19 5
8 9 6 <-> 19 10 2
11 9 2 <-> 9 19 4
8 10 6 <-> 1 10 2
11 10 2 <-> 9 0 0
8 11 5 <-> 0 0 7
9 11 4 <-> 5 14 2
10 11 4 <-> 10 18 0
11 11 3 <-> 19 19 3
