2
6
8 4
27 36
0 0 0 0 0 0 0 - - - - - - - - - - - - - - - - - - - - - - 0 0 0 0 0 0 0
- 0 0 0 0 0 0 0 - - - - - - - - - - - - - - - - - - - - 0 0 0 0 0 0 0 -
- - 0 0 0 0 0 0 0 - - - - - - - - - - - - - - - - - - 0 0 0 x 0 0 0 - -
- - - 0 0 0 0 0 0 0 - - - - - - - - - - - - - - - - 0 0 0 x 0 0 0 - - -
- - - - 0 0 0 0 0 0 0 - - - - - - - - - - - - - - 0 0 0 x 0 0 0 - - - -
- - - - - 0 0 x x x 0 0 - - - - - - - - - - - - 0 0 0 0 0 0 0 - - - - -
- - - - - - 0 0 0 0 0 0 0 - - - - - - - - - - 0 0 0 0 0 0 0 - - - - - -
- - - - - - - 0 0 0 0 0 0 0 - - - - - - - - 0 0 0 0 0 0 0 - - - - - - -
- - - - - - - - 0 0 0 0 0 0 0 - - - - - - 0 0 0 0 0 0 0 - - - - - - - -
- - - - - - - - - 0 0 0 0 0 0 0 - - - - 0 0 0 0 0 0 0 - - - - - - - - -
- - - - - - - - - - 0 0 0 0 0 0 0 - - 0 0 0 0 0 0 0 - - - - - - - - - -
- - - - - - - - - - - 0 0 0 b 0 0 0 0 0 0 b 0 0 0 - - - - - - - - - - -
- 0 0 0 0 0 0 0 - - - 0 0 0 0 0 0 0 0 0 0 0 0 0 0 - - - 0 0 0 0 0 0 0 -
0 0 0 0 c 0 0 0 - - - - - - - - - - - - - - - - - - - - 0 0 0 c 0 0 0 0
- 0 0 0 0 0 0 0 - - - 0 0 0 0 0 0 1 2 0 0 0 0 0 0 - - - 0 0 0 0 0 0 0 -
- - - - - - - - - - - 0 0 0 0 0 0 2 1 0 0 0 0 0 0 - - - - - - - - - - -
- - - - - - - - - - 0 0 0 0 0 0 0 - - 0 0 0 0 0 0 0 - - - - - - - - - -
- - - - - - - - - 0 0 0 x 0 0 0 - - - - 0 0 0 0 0 0 0 - - - - - - - - -
- - - - - - - - 0 0 0 x 0 0 0 - - - - - - 0 0 0 0 0 0 0 - - - - - - - -
- - - - - - - 0 0 0 x 0 0 0 - - - - - - - - 0 0 x x x 0 0 - - - - - - -
- - - - - - 0 0 0 0 0 0 0 - - - - - - - - - - 0 0 0 0 0 0 0 - - - - - -
- - - - - 0 0 0 0 0 0 0 - - - - - - - - - - - - 0 0 0 0 0 0 0 - - - - -
- - - - 0 0 0 0 0 0 0 - - - - - - - - - - - - - - 0 0 0 0 0 0 0 - - - -
- - - 0 0 0 0 0 0 0 - - - - - - - - - - - - - - - - 0 0 0 0 0 0 0 - - -
- - 0 0 0 0 0 0 0 - - - - - - - - - - - - - - - - - - 0 0 0 0 0 0 0 - -
- 0 0 0 b 0 0 0 - - - - - - - - - - - - - - - - - - - - 0 0 0 b 0 0 0 -
0 0 0 0 0 0 0 - - - - - - - - - - - - - - - - - - - - - - 0 0 0 0 0 0 0
1 26 4 <-> 34 0 0
4 26 4 <-> 31 0 0
31 26 4 <-> 1 0 0
34 26 4 <-> 4 0 0
11 11 6 <-> 7 12 2
11 12 6 <-> 7 13 2
24 11 2 <-> 28 12 6
24 12 2 <-> 28 13 6