3
1
0 0
15 15
0 0 0 0 0 - - - - - 0 0 0 0 2 
0 0 0 0 0 - - - - - 0 0 0 2 0 
0 0 0 0 0 - - - - - 0 0 i 0 0 
0 0 0 0 0 0 0 0 0 0 0 0 0 0 0 
0 0 0 0 0 0 0 0 0 0 0 0 0 0 0 
- - - 0 0 0 0 0 0 0 0 0 - - - 
- - - 0 0 0 0 2 2 0 0 0 - - - 
- - - 0 0 0 0 0 2 0 0 0 - - - 
- - - 0 0 0 0 0 0 0 0 0 - - - 
- - - 0 0 0 0 0 0 0 0 0 - - - 
0 0 0 0 0 0 0 0 0 0 0 0 0 0 0 
0 0 0 0 0 0 0 0 0 0 0 0 0 0 0 
0 0 0 0 0 - - - - - 0 0 1 0 0 
0 1 0 0 0 - - - - - 0 0 1 1 0 
2 0 0 0 0 - - - - - 0 0 0 0 0 
0 0 7 <-> 14 14 3
14 0 1 <-> 0 14 5
4 11 3 <-> 10 11 5
4 3 1 <-> 10 3 7
11 10 1 <-> 11 4 3
3 10 7 <-> 3 4 5
